11111111111111111111111111111111111111111
10101000001000000000000000100000001010001
10101010101110111110111110101011101010101
10101010100010000010100010101010001000101
10101010111011111010111010101010111110101
10100010001000100010001000101010100010101
10111111101110101111101011101010101011101
10000000101000101000001010101010001000101
11111110101011101011111010101011111110101
10000010101010001010001010101010000000101
10111010101011111010101010101010111111101
10001010001000000010101010001010100000001
11101011111111111110101011111010101111101
10001010000000000000101000000010100000101
10111110111111111010111111111110111110101
10000010000010000010100000000010000000101
10111011111010111110101110111111111111101
10001000000010100000100010000000000010001
11111111101110111111101111111110111010111
10000000101000100010001000000000100010001
10111110111010101010111011111110111111101
10001000100010101000100010000010100000101
11101011101110101111101110111010101110101
10001010001000100000100010101010100010001
10111010111011111110111010101011111011111
10001010001000100010101000101000000010001
10101011101111101010101111101111111111101
10101010001000001010000010000000000000101
10101010101011111011111011101111101110101
10101000101000001000001000100000100010001
11101111111111101110111110101111101011101
10001000100000001010000000101000101010101
10101010101111111011111111111010101010101
10101010100010000000001000000010101010001
10111010111011111110101011111110111010111
10000010001000000000101010000010000010101
10111110101111111111101011101111111110101
10100010101000000000101000101000000010101
10101010111011111011101110101010111110101
10001010000000001000000000100010000000001
11111111111111111111111111111111111111111