11111111111
10100000001
10111111101
10000000001
11111111101
10001000001
10111011111
10000010001
10111111101
10000000001
11111111111